...................0
......X............1
......X.....XXXXX..2
......X....XX......3
...........XXXXX...4
..X...........X....5
..XXX..........X..X6
XXX...........X....7
..X................8
..X................9
0123456789012345678